Map Width: 21, Map Height: 21, Current Round: 15, Seed: 1919137927, PlayerBounty: 480
#####################
#   ++   + +   + + +#
# # # # # # # # # # #
#  a+  + + + +  ++  #
#+# # # # # # # # #+#
#        + +        #
#+# # #+#+#+#+# # #+#
#                   #
# # #+# #+#+# #+# # #
#+     +++++++     +#
#+# #+#+#+$+#+#+# #+#
#+     +++++++     +#
# # #+# #+#+# #+# # #
#                   #
#+# # #+#+#+#+# # #+#
#        + +        #
#+# # # # # # # # #+#
#  ++  + + + +  +b  #
# # # # # # # # # # #
#+ + +   + +   ++   #
#####################
---------------------------
Player Name: John
Key: A
Points: 22
Status: Alive
Bombs: {x:4,y:4,fuse:4,radius:1}
BombBag: 0
BlastRadius: 1
---------------------------
---------------------------
Player Name: jessica
Key: B
Points: 22
Status: Alive
Bombs: {x:18,y:18,fuse:4,radius:1}
BombBag: 0
BlastRadius: 1
---------------------------
